5,1,1,6,1,5,30,0,30
5,1,1,6,1,15,-30,0,30
2,3,1,5,5,23,21,0,30
2,3,1,5,5,23,-21,0,30
3,1,1,4,1 ,30,30,0,21
3,1,1,4,1 ,30,-30,0,21
3,1,1,3,-1,55,30,0,24
3,1,1,3,-1,63,-30,0,24