5,5,1,1,1,-1,1,21,0,30
15,5,1,1,1,-1,1,-21,0,30
25,5,1,1,2,1,1,30,0,24
35,5,1,1,2,1,1,-30,0,24
45,1,1,1,1,5,10,-21,0,30
45,1,1,1,1,5,10,-21,0,30
55,3,1,1,3,-1,2,30,0,24
63,3,1,1,3,-1,2,-30,0,24
