5,1,1,6,1,5,30,0,30
5,1,1,6,1,15,-30,0,30
2,3,1,5,5,20,21,0,30
2,3,1,5,5,20,-21,0,30
3,1,1,4,1,35,30,0,21
3,1,1,4,1,35,-30,0,21
3,1,1,3,2,45,30,0,24
3,1,1,3,2,45,-30,0,24