1,1,5,-1,-1,5,0,0,60
1,1,1,6,2,15,30,0,30
1,1,1,6,2,15,-30,0,30
1,1,1,6,2,30,30,0,30
1,1,1,6,2,30,-30,0,30