5,1,1,1,-1,5,21,0,30,
5,1,1,1,-1,15,-21,0,30,
5,1,1,2,1,25,30,0,24,
5,1,1,2,1,35,-30,0,24,
1,1,1,1,5 ,45,21,0,30,
1,1,1,1,5 ,45,-21,0,30,
3,1,1,3,2,55,30,0,24,
3,1,1,3,2,63,-30,0,24,