5,1,1,5,-1,2,1000,0,0,60
15,1,1,1,6,2,3,30,0,30
15,1,1,1,6,2,3,-30,0,30
30,1,1,1,6,2,3,30,0,30
30,1,1,1,6,2,3,-30,0,-30
