5,5,1,1,6,1,10,30,0,30
15,5,1,1,6,1,10,-30,0,30
23,2,1,1,5,5,20,21,0,30
23,2,1,1,5,5,20,-21,0,30
30,3,1,1,4,1,5,30,0,21
30,3,1,1,4,1,5,-30,0,21
40,3,1,1,3,-1,10,30,0,24
50,3,1,1,3,-1,10,-30,0,24
